11111111111111111111111111
10C010000000010C0100000001
11000001110000000000000001
11100011000101111100000001
100001110010010E0100000001
11100001001111101100000001
10000000000001000100000001
1P000010000001000000000001
11111111111111111111111111