11111111111111111111111111
10001000000001000100000001
1100000111000C000C00000001
11100011000101111100000001
10000111001001E00100000001
11100001001111101100000001
100000000000010C01000B0001
1P000010000001000C00000001
11111111111111111111111111