11111111111111111111111111
10C010000000010C0100000001
1100000111000000000C000001
11100011000101111100000001
10000111001001E00100000001
11100001001111101100000001
100000000C00010001000B0001
1P000010000001000000000001
11111111111111111111111111