111111111111111111
10C010000000010C01
110000011100000001
1110001111110100B1
1P0001111110010E01
111111111111111111